NO ./path_to_the_north_texture
SO ./path_to_the_south_texture
WE ./path_to_the_west_texture
EA ./path_to_the_east_texture

F 220,100,0
C 225,30,0

     1
    111
   11011
  1100011          1          1
11111111111       111        111
11000000011      11011      11011
11000000011     1111111    1111111
111111111111  1101 101111   11 11
111111111111111111111111111111111
11000000011   11000000011   11011
11000000011   11000000011   11011
110000000111111100000001111111011
1100010001000001000100001   11011
1100111001000001001110001   11011
110011100100W001001110001   11011
111111111111111111111111111111111